1111
1001
10P1
11011001
1011
10E1
1111
