111111111111111111111111111111111111111111111111111111111111
100101001000001001010000000100000010000000010100010000000101
100101001001001001010010100000010000101001000100000010010101
100001101101100000011111111111111111111111101111010010010101
111101000001001001010010001010000100000001000100011110110001
100001011111111111110000000010000100101000010100000000010101
100101000001001001011111101111101110101101010001101111111101
110111001001001001010010000010000100101001010100101000100101
100001001000000011010000010000000111101111110100001000100101
111011011111001000010010010110010100100101010111000000001101
100001000001111101111111010010110000100001000100001011100101
101111000001000101010000011010010100000111010100101000101101
100001111011000001010010010010010110100100010100001000100101
100101000001000101010010010011000100100101010110111111111111
110111000001101111011111110110010100100001010100100010010001
100001111011000001010010000010111111111111111100001010010001
111101000001000000010010010010000000010000010101111010000101
100101111111110111111000111110001010010010010100101010010001
100001000010000000010010010011101111110010000100001010010001
11011100101000100101001000001000100101111011E101111111011111
100001000011111111011111110110001000010000000100000010001001
100101110110010010010010010011100011011111101101111000000001
100101000010010010010000000010001001010000000100000010111111
101111000010000010000111010010001001010111111100100010000C01
100101001011010000010000010111111011000010000111111110111111
100001011110011110110001010010000001010000010100000100000001
111011001000010000011111111011111101111111010100010100P10001
100001001011111101110010010010000000010001010101110101111011
100000000010000000010000000010010000010000010100010000010001
111111111111111111111111111111111111111111111111111111111111
