11111111111111111111
1E010100101000010001
10000000000000010001
10010101111110111101
11110100101000000001
10010100101001010001
100001000P1000010001
11110111111110111111
10000100001010000001
10010100101010010101
10110111101010110101
10010100101010010101
11011100001000110111
10000100000010000001
11110111011110111111
10000100000010000001
11111111011111111111
10010101001E10100101
10000101000000100001
10010001111101110111
11011101001000100101
10000101000000100001
11011111000000110111
10000101110111100101
1001010100000C100001
10111101111010001011
10000001000000100001
11111101111111110111
10000000000000000001
11111111111111111111
