111111111111111111111111111111111111111111111111111111111111111111111111111111111111111111111111111111111111111111111111
100001010000101010100100100001001001000100101001000000000100101000010001001000100001001000000000000010000100101001010001
100101010010100010100000100101001001000100000000000100100100101001010001001000100101001000100101001010100100001000010001
100100000010001010111110101100001011000000101101011111111100001011110001011011111100011110100001011110101111101000010001
10111111101111100C100010100101000001111011111001001000100111011001011011000000100001000000111011001010100000101110110111
100001010000001010100000110111001001001001001001001000100100001000010001111011100101001000100001000000100100000000010001
100001010001000010110110100101111011000000001011100011110100100001000001001000111111111111111111111111101111111111110001
1110000100010111101P0000100101000001111101001001001000000111110111111111001000100100001000001010010000101001001010011101
100001011011000010111101101101000101000001101001111111011100010100100101000000100000101001001010010010101000001010010001
100001010001001010100000000001000101001001001011001001000000000100000001011011100100101011000010000010101001000000011101
111011111111111111101111111111111111011011001001000001000100010111111011001000111111100001000011010110101111111110110001
100000100100000010100010000000001001001001001001101011101111110000101001111110100100101111110000010010101000100010010001
100100100000100010000000001010001001101111111001001000000100010100101001000000100000101000000011110111101000000010010001
110000110111100010100010001010000001001000001111111111110100000110001101111110100100001001001010010000101000100010011101
100100100010110000111111111111011111000000101000000000000100010100100001001010111111011001000010010010101111111011010001
110111100000100010100100101001010001111111111111111101111111111111111111001010100010001111011110000000101001001000011101
100100101111111111100000000000010001001000001010000100010001000000000001100000100000001001001011111101101001001010010001
100100100010100100100100101001011011001001001010010100010000000100101001001010111011011000001010010000001001000011010001
101101100010000100101110111011010001001011100010010110000111101100001011111011100010001001000010000010101000001010010001
100000100000100110100100001001011011101001001000011100010001000111011001001000111111111111111111111011111001001010000101
100100001011110000101111111111110001001111101110000111111101110100001001000010100100000100000000101001001111111011110001
111101100000100110100100010010010001000000000010111100100001000111011111111110100100100100010100001000001001000001010001
100100100100000100100100000010010001101001010010000100000101000100000001000000100100100111111111100010111001010000011011
100100101100100100100111011010011011001101111010111100100101110111111111000100100001101100100100101000001100010111110001
101101100001101110100000010011010001101000000010000110111111000000001001000100100100000100000100001001001001010010010111
100000100100000100100111111010010001001001010110010100010001001000101001111101101111111111110110111011111011110000010001
111101110111111111110100100010011011001001010010010100000001101011101101000000100100100100000000001000001000010010010001
100000100000000000100100100011010001111111111110111101111111001000000001111011100000100100000100101111011111111011111101
111111101111111111100101111010000011001000001000000100010001111111011111000000111100000111011111101000001001000000010001
100000001001000000100100000000010001000010001001000100010001000100010001111101100000100100000100001000001001010010010001
100010000001010010111111011111111111110111100000001101110001000100010001001000100000100100100100101110111101011010111011
111011101000010110100000000000000001000001001000000100010111000110000101000010111011111100000100101000001000010010010001
100010001001010010100100001000100101000000001110110001110001011100010001110111100001000101111111111000001111111111010001
111111111111111111110111111111111111011111101000000100000001000100010001000000100101000100100000001011011001000100011101
100100100100010010000100010100100001000101001001000111111101101100010001000100000000010000000010001001001000000100010001
100100000100000010000000010000100101000001001000000100000001000111111100011111110111000111111111101111111101010000110001
110000100100010011101100010100001101111111111111111101111111000000000001001010100001000100010010100010001001000100011011
100111110111010110000110000100100001000100010010100100010001000100101001000000111111101100010010100000000001000100010001
100100000000010000000100010100100101000100010000000100010001111110111111110110100000000111011000101111011001110101110001
111111111111111101111111111111111111000000011010100111010111001000010001000010100100010100000010000010001001000100010001
100100100101000100010000010001000101101111110010110100010001001000010001111111111111111111111111111111111111111111011111
100000100001000100010100010001000101000000011011100000011011000000000001001010100101000010010000000000100001000010010001
110111101101000111000101000000010001001010000000100100010001111110111111000010100000010010010001000100000101001010000001
100000000101011100010100010001000101011111011011111111110001000010010001110110100101010010011111011111101111111010111101
100010111101000111111110111111111111001010010010000010010111001010000001000010111111110111010010000000100001000010010001
110110100001000100010010100100010001000010010010000010010001001000010001001000100001000000010010010100101111001011111011
100010100101011100010010100100000001001010010111101000011011111111111011111011100000000010010010010101100000011010000001
111111111101000100010010000000010001111111010000001011010001000100100001001010111011111110110000011100100101001010010001
100000001000000111011010101111111111000000010010000010010001000000100001000000100001001010010010010100100101000000010101
100010000001000100000000100001000101001010011011101010000111011110001011111101100101000010110010000100101111110111111111
110110001001011111111110100101000101001010010010001010010001000100100001000000101100011010010111011111100101000001001001
1000101111010001E0010000101101000001111111011111111111111111111111111111000010100001000010000010000000100001001001001001
100010001001000000000000100101011100001010000100010001010010000000001001110000110111110111111111111111111011001000000001
110110000001000111011101101111000101001010000000010001010000100100101001000010100001000010001001010001000001111101111101
100011110111110100010000100101000101000011101100010000000110100000101001001010110111111110001001010001000001000101000001
100010010101000100010010100001110001101110000101111110110000111011100001111011100001001010000001011011011111000000001001
100010000001000101111111100100000101000010000100010000011101100000101001000000100101000011111011010000000001111110111111
111111011111011100000000111111101111001010111100000101110000100100101001111101111100001110000000011101001001001000000001
100000000001000100101000100000000001001000000100010000010000100100001001000000000001000010001001000001001001000010010101
111111111111111111111111111111111111111111111111111111111111111111111111111111111111111111111111111111111111111111111111
