111111111111111111111111111111
100100001010010001000000010001
100000101010000001000100010C01
100111101010010000000100010001
110100100000111111110111111101
100100001010010010000000010001
111111111110110010100100010111
1000100000000100001P0100010001
100010010001011110111111110001
111010011011110000010001011101
100011010001010010010001010001
100000010000011111010111010001
111111111111010010000001011101
100000000000010010011100010001
100100100010011010110001010001
110111100000010000010001011101
100000111101111101111111110001
100100100001010001001000E10111
110111100101010001001010010001
100000110100010001000010010111
100010100001011101110111010001
100010100101010000000010010001
111111111101111111111110000111
100000000000010000000000010001
101111111111111111111111110111
100010101010001001001001010001
100010101010001000001000011011
101000001000100011011111010001
100010100010001001000000010001
111111111111111111111111111111